#####################
#............#???????
#..........#.#???????
#..........#.#???????
#......|...#.#???????
#..........#.#???????
#..........#.#???????
#...|......#.#???????
#..........#.########
#..........#.......##
#..........##########
#..........#????????#
#..........#????????#
#..........#????????#
#####################
